_____                          __________                                                                                                      
_____                          __________                                                                                                      
_____                          __________                                                                                                      
_____                          __________                                                                                                      
_____                          __________                                                                                                      
_____                          __________                                                                                                      
_____                          __________                                                                                                      
_____                          _________                                                                                                       
_____                          _______                                                                                                         
_____           ....        ..._______                                                                                                         
_____          .____.       _________         3       .....                       3                                                            
_____ 3  3  3 .______.                  ...............___.....................................................................................
_____.........________       3       ..._______________________________________________________________________________________________________
______________________...............__________________________________________________________________________________________________________
_______________________________________________________________________________________________________________________________________________
_______________________________________________________________________________________________________________________________________________
_______________________________________________________________________________________________________________________________________________
_______________________________________________________________________________________________________________________________________________
_______________________________________________________________________________________________________________________________________________
_______________________________________________________________________________________________________________________________________________
_______________________________________________________________________________________________________________________________________________
