100000000000000000000000000
100000000000000000300000000
100000000000000000000000000
100000010000110000000001111
100000001000000000101000001
111000111100000000100000001
222111222210000300100010001
222222222221000000100030001
222222222222111111100000112
222232222222222222211111222
222202222222222222222222222
222212222222222222222222222
222222222222222222222222222
222222222222222222222222222
222222222222222222222222222
