___________
___________
___________
___________
___________
___________
___________
___________
___________
___________
___________
___________
___________
___________
___________
___________
___________
___________
___________
___________
___________
___________
___________
___________
___________                                  _  
___________                                  _  
___________                                  _     
___________                                  _  
___________                                  _                                 _____________________________
___________                                  _                                 _____________________________
___________                                  _                                 _____________________________
___________                                  _                                 _____________________________
___________                                  v                                 _____________________________
_________v_                                  v  .           +    .  .          _____________________________
________vvv                                  v  v.    3  ........_  _kkkkkkkkkk_____________________________
___--___vvv                   ..             v  vv.......___--____  vv______-_______________________________
___--____vv         ..    .        .            vvv__--___________  vv__-________________v__________________
___-______v+  s          ._   3 3  _   4   3    vv___--___________  vvv___-_____________vv                  
__________v.......     ..__........_............v____________--___   vvvv_____-________vvv     
_____-_______--___     _______-_________-----________________----_      vv___---___--___vv                 g
____________--___-kkkkk______---________---_________--____________        ____--____-____v   vv_____________
________________-----_______________--____________________________                           vv_____________
_________________--_______--_______--____________________--_______   _    3         _    3   v______________
__________________________________________________________________kkk____          -__     _________________
___________________________________________________________________________       _--__---__________________
_______________________________________________________________________--___     ___________________________
______________________________________________________________________---____   _--_________--______________
_________________________________________________________________________________-__________________________
__________________________________________________________________________-_________________________________
____________________________________________________________________________________________________________
____________________________________________________________________________________________________________
____________________________________________________________________________________________________________
____________________________________________________________________________________________________________
____________________________________________________________________________________________________________