0000000000000000000
0000000000000000000
0000000000000000000
1110001111000000000
2221112222100000000
2222222222210000000
2222222222221111111
2222222222222222222
2222222222222222222