_____________________________                          __________                                                 _________________________________________________________
_____________________________                          __________                                                 _________________________________________________________
_____________________________                          __________                                                 _________________________________________________________
_____________________________   3                      __________                                                 _________________________________________________________
___________________________________                    __________                                                 _________________________________________________________
_____________________________                          __________                                                 _________________________________________________________
_____________________________                          __________                                                 _________________________________________________________
_____________________________                          __________                                                 _________________________________________________________
_____________________________                          __________                                                 _________________________________________________________
_____________________________                          __________                                                 _________________________________________________________
_____________________________                          __________                                                 _________________________________________________________
_____________________________                          __________                                                 _________________________________________________________
_____________________________                          __________                                                 _________________________________________________________
_____________________________                          __________                                                 _________________________________________________________
_____________________________                          __________                                                 _________________________________________________________
_____________________________                          v__v______                                                 _________________________________________________________
_________--__________________                          vvvv______                                                 _________________________________________________________
________----_________________                          vvvv______                                                 _________________________________________________________
__________--_________________                   ....   vvv_______                                                 _________________________________________________________
___________--________________                      _   vv________                                                 _________________________________________________________
_____________________________                      _   v_______vv                                                 _________________________________________________________
_____________________________                      _   v________v                                                 _________________________________________________________
_____________________________                      -   __--____vv                                                 _________________________________________________________
____________________________v                      -   _--_____vv                                                 _________________________________________________________
__________________________vvv                          _________v3                                                _________________________________________________________
_________________________vvvv                        ..__________-                                                _________________________________________________________
__________________________vvv                      .._________---_........                                        _________________________________________________________
___________________________vv                  ..     _____________--_____                                        _________________________________________________________
____________________________v           .  .                                                                      _________________________________________________________
___________________________vv          ._  _.                                  ...   3    3        ..      g      _________________________________________________________
___________________________vv  s      .__kk__.                3 ..............._--.................-_............._________________________________________________________
____________________________v.........____--__           .   ..._______---_______--____--_________________--______________________________________________________________
_______________________________--_________--__...   .   .-...____-_________________________________________________________________________________________________________
_________________________________________________kkk_kkk_-_____---____________________---__________________________________________________________________________________
___________________---__________________-______________________________________________--__________________________________________________________________________________
_______________________________________---_____-____________-______________________________________________________________________________________________________________
_______________________________________-______________-_________-__________________________________________________________________________________________________________
___________________________________________________________________________________________________________________________________________________________________________
___________________________________________________________________________________________________________________________________________________________________________
___________________________________________________________________________________________________________________________________________________________________________
___________________________________________________________________________________________________________________________________________________________________________
