000000000000000000000000000
000000000000000000300000000
000000000000000000000000000
000000010000110000000001111
000000001000000000001000000
111000111100000000000000000
222111222210000300000010000
222222222221000000000030001
222222222222111111100000112
222232222222222222211111222
222202222222222222222222222
222212222222222222222222222
222222222222222222222222222
222222222222222222222222222
222222222222222222222222222
