_____________________________                          __________                                                 _________________________________________________________
_____________________________                          __________                                                 _________________________________________________________
_____________________________                          __________                                                 _________________________________________________________
_____________________________   3                      __________                                                 _________________________________________________________
___________________________________                    __________                                                 _________________________________________________________
_____________________________                          __________                                                 _________________________________________________________
_____________________________                          __________                                                 _________________________________________________________
_____________________________                          __________                                                 _________________________________________________________
_____________________________                          __________                                                 _________________________________________________________
_____________________________                          __________                                                 _________________________________________________________
_____________________________                          __________                                                 _________________________________________________________
_____________________________                          __________                                                 _________________________________________________________
_____________________________                          __________                                                 _________________________________________________________
_____________________________                          __________                                                 _________________________________________________________
_____________________________                          __________                                                 _________________________________________________________
_____________________________                          __________                                                 _________________________________________________________
_________--__________________                          __________                                                 _________________________________________________________
________----_________________                          __________                                                 _________________________________________________________
__________--_________________                   ....   __________                                                 _________________________________________________________
___________--________________                      _   __________                                                 _________________________________________________________
_____________________________                      _   __________                                                 _________________________________________________________
_____________________________                      _   __________                                                 _________________________________________________________
_____________________________                      -   __--______                                                 _________________________________________________________
_____________________________                      -   _--_______                                                 _________________________________________________________
_____________________________                          __________3                                                _________________________________________________________
_____________________________                        ..__________-                                                _________________________________________________________
_____________________________                      .._________---_........                                        _________________________________________________________
_____________________________                  ..     _____________--_____                                        _________________________________________________________
_____________________________           .kk.                                                                      _________________________________________________________
_____________________________          .____.                                  ...   3    3        ..      g      _________________________________________________________
_____________________________  s      .______.                3 ..............._--.................-_............._________________________________________________________
_____________________________.........____--__               ..._______---_______--____--_________________--______________________________________________________________
_______________________________--_________--__... . . . . ...____-_________________________________________________________________________________________________________
_________________________________________________k_k_k_k_k_____---____________________---__________________________________________________________________________________
___________________---__________________-______________________________________________--__________________________________________________________________________________
_______________________________________---_____-____________-______________________________________________________________________________________________________________
_______________________________________-______________-_________-__________________________________________________________________________________________________________
___________________________________________________________________________________________________________________________________________________________________________
___________________________________________________________________________________________________________________________________________________________________________
___________________________________________________________________________________________________________________________________________________________________________
___________________________________________________________________________________________________________________________________________________________________________
