_____                          __________                                                                                                      
_____                          __________                                                                                                      
_____                          __________                                                                                                      
_____                          __________                                                                                                      
_____                          __________                                                                                                      
_____                          __________                                                                                                      
_____                          __________                                                                                                      
_____                          _________                                                                                                       
_____                        3 _______                                                                                                         
_____           ....        ..._______                                                                                                         
_____          .____.       _________         3       .....                       3                                                            
_____ 3  3  3 .______.                  ...............___.....................................................................................
_____..........______.       3       ..._______________________________________________________________________________________________________
_____________________................__________________________________________________________________________________________________________
_______________________________________________________________________________________________________________________________________________
_______________________________________________________________________________________________________________________________________________
_______________________________________________________________________________________________________________________________________________
_______________________________________________________________________________________________________________________________________________
_______________________________________________________________________________________________________________________________________________
_______________________________________________________________________________________________________________________________________________
_______________________________________________________________________________________________________________________________________________