100000000000000000000000000
100000000000000000300000000
100000000000000000000000000
100000010000110000000001111
100000001000000000101000001
111000111100000000000000001
222111222210000300100010001
222222222221000000100030001
222222222222111111100000112
222232222222222222210111222
222200002222222222220222222
222222222222200002220222222
222222222220000000020222222
222222222200000000000222222
222222222222222222222222222
