000000000000000000000000000
000000000000000000000000000
000000000000000000000000000
000000010000110000000001111
000000001000000000001000000
111000111100000000000000000
222111222210000000000010000
222222222221000000000000001
222222222222111111100000112
222222222222222222211111222
222222222222222222222222222
222222222222222222222222222
222222222222222222222222222
222222222222222222222222222
222222222222222222222222222
