______                          __________                                                 ___________________________
______                          __________                                                 ___________________________
______                          __________                                                 ___________________________
______                          __________                                                 ___________________________
______                          __________                                                 ___________________________
______                          __________                                                 ___________________________
______                          __________                                                 ___________________________
______                          __________                                                 ___________________________
______                          __________                                                 ___________________________
______                          __________                                                 ___________________________
______                          _________                                                  ___________________________
______                          _______                                                    ___________________________
______           .... s      ..._______                                                    ___________________________
______          .____.       _________                  ...                            g   ___________________________
______ 3  3  3 .______.                  ...............___................................___________________________
______.........________           3   .....___________________________________________________________________________
_______________________... . . .......________________________________________________________________________________
__________________________k_k_k_______________________________________________________________________________________
______________________________________________________________________________________________________________________
______________________________________________________________________________________________________________________
______________________________________________________________________________________________________________________
______________________________________________________________________________________________________________________
______________________________________________________________________________________________________________________
______________________________________________________________________________________________________________________
______________________________________________________________________________________________________________________


s = spawn //does not set the spawn
g = goal //does not set the goal
3 = enemy
_ = ground
. = grass block
  = emty space