222220000000000000000000000000022222
222220000000000000000000000000022222
222220000000000000000000000000022222
222220000000000000000000000000022222
222220000000000000000000000000022222
222220000000000000000000000000022222
222220000000000000000000000000022222
222220000000000000000000000000022222
222220000000000000000000000000022222
222220000000000011100000000000022222
222220000000000112110000000000022222
222220300300301122211000000000022222
222221111111111222221000000003022222
222222222222222222221111111111122222
222222222222222222222222222222222222
222222222222222222222222222222222222
222222222222222222222222222222222222
