130000000000000000000000000
111000000000000000300000000
122100000000030000000000300
100000000000111000000001111
100000001000000000111000001
111000111100000000000000001
222111222210000000000000001
222222222221000300000000001
222222222222111111100030112
222200002222222222210111222
222000032222222222220222222
200002222222200002220222222
202222222220000000020222222
200000000000000000000222222
222222222222222222222222222
