230000000000000000000000000
211000000000000000300000000
222100000000030000000000300
200000000000111000000001111
200000001000000000111000001
211000111100000000000000001
222111222210000000000000001
222222222221000301000000001
222222222222111111100030112
222200002222222222210111222
222000032222222222220222222
200002222222200002220222222
202222222220000000020222222
200000000000000000000222222
222222222222222222222222222
