______                          __________                                                 ___________________________
______                          __________                                                 ___________________________
______                          __________                                                 ___________________________
______                          __________                                                 ___________________________
______                          __________                                                 ___________________________
______                          __________                                                 ___________________________
______                          __________                                                 ___________________________
______                          __________                                                 ___________________________
______                          __________                                                 ___________________________
______                          __________                                                 ___________________________
______                          _________                                                  ___________________________
______                         3_______                                                    ___________________________
______           .... s      ..._______                                                    ___________________________
______          .____.       _________         3        ...           3                g   ___________________________
______ 3  3  3 .______.                  ...............___................................___________________________
______.........________       3       ..._____________________________________________________________________________
_______________________...............________________________________________________________________________________
______________________________________________________________________________________________________________________
______________________________________________________________________________________________________________________
______________________________________________________________________________________________________________________
______________________________________________________________________________________________________________________
______________________________________________________________________________________________________________________
______________________________________________________________________________________________________________________
______________________________________________________________________________________________________________________
______________________________________________________________________________________________________________________


s = spawn //does not set the spawn
g = goal //does not set the goal
3 = enemy
_ = ground
. = grass block
  = emty space