______                          __________                                                 ___________________________
______                          __________                                                 ___________________________
______                          __________                                                 ___________________________
______                          __________                                                 ___________________________
______                          __________                                                 ___________________________
______                          __________                                                 ___________________________
______                          __________                                                 ___________________________
______                          __________                                                 ___________________________
______                          __________                                                 ___________________________
______                          __________                                                 ___________________________
______                          _________                                                  ___________________________
______                         3_______                                                    ___________________________
______          3....        ..._______                                                    ___________________________
______          .____.      ._________         3        ...           3                g   ___________________________
______ s       .______.                  ...............___................................___________________________
______.........________       3       ..._____________________________________________________________________________
_______________________...............________________________________________________________________________________
______________________________________________________________________________________________________________________
______________________________________________________________________________________________________________________
______________________________________________________________________________________________________________________
______________________________________________________________________________________________________________________
______________________________________________________________________________________________________________________
______________________________________________________________________________________________________________________
______________________________________________________________________________________________________________________
______________________________________________________________________________________________________________________
