0000000000
0000000000
0000000000
1110001111
2221112222
2222222222