______________________________                         __________                                                 _________________________________________________________
_____________________________                          __________                                                 _________________________________________________________
_____________________________                          __________                                                 _________________________________________________________
_____________________________   3                      __________                                                 _________________________________________________________
___________________________________                    __________                                                 _________________________________________________________
_____________________________                          __________                                                 _________________________________________________________
_____________________________                          __________                                                 _________________________________________________________
_____________________________                          __________                                                 _________________________________________________________
_____________________________                          __________                                                 _________________________________________________________
_____________________________                          __________                                                 _________________________________________________________
_____________________________                          __________                                                 _________________________________________________________
_____________________________                          __________                                                 _________________________________________________________
_____________________________                          __________                                                 _________________________________________________________
_____________________________                          __________                                                 _________________________________________________________
_____________________________                          __________                                                 _________________________________________________________
_____________________________                          __________                                                 _________________________________________________________
_____________________________                          __________                                                 _________________________________________________________
_____________________________                          __________                                                 _________________________________________________________
_____________________________                          __________                                                 _________________________________________________________
_____________________________                          __________                                                 _________________________________________________________
_____________________________                          __________                                                 _________________________________________________________
_____________________________                          __________                                                 _________________________________________________________
_____________________________                          __________                                                 _________________________________________________________
_____________________________                          __________                                                 _________________________________________________________
_____________________________                          __________3                                                _________________________________________________________
_____________________________                        ..___________                                                _________________________________________________________
_____________________________                        _____________........                                        _________________________________________________________
_____________________________                         ____________________                                        _________________________________________________________
_____________________________           ....                                                                      _________________________________________________________
_____________________________          .____.                                  ...   3    3        ..      g      _________________________________________________________
_____________________________  s      .______.                3 ...............___.................__............._________________________________________________________
_____________________________.........________               ...___________________________________________________________________________________________________________
______________________________________________... . . . . ...______________________________________________________________________________________________________________
_________________________________________________k_k_k_k_k_________________________________________________________________________________________________________________
___________________________________________________________________________________________________________________________________________________________________________
___________________________________________________________________________________________________________________________________________________________________________
___________________________________________________________________________________________________________________________________________________________________________
___________________________________________________________________________________________________________________________________________________________________________
___________________________________________________________________________________________________________________________________________________________________________
___________________________________________________________________________________________________________________________________________________________________________
___________________________________________________________________________________________________________________________________________________________________________
