








                      s
.................          .........................
_________________          _________________________
_________________          _________________________
_________________          _________________________
_________________          _________________________
_________________          _________________________
_________________          _________________________
_________________          _________________________
_________________          _________________________
_________________          _________________________
_________________          _________________________
_________________          _________________________
_________________          _________________________
_________________          _________________________
_________________          _________________________
_________________          _________________________
_________________          _________________________
_________________          _________________________
_________________          _________________________








                   ... ...    
                ...___k___...    
................_____________.......................
____________________________________________________
____________________________________________________
____________________________________________________
____________________________________________________
____________________________________________________
____________________________________________________
